                   /-----------\                                                                                     /--------\                       
     /-------------+-----------+----------------------------------------------------------------------\              |        |                       
     |             |  /--------+------------------------------\                                       |              |        |                       
     |           /-+--+--------+------------------------------+---------------------------------------+---------\    |  /-----+---------------------\ 
   /-+-----------+-+--+--\/----+-----------\                  |                         /-------------+-\       |    |  |     |                     | 
   | |      /----+-+--+--++----+-----------+------------------+---------------------\   |             | |       |    |  |     |                     | 
   | |      |    | |  |  ||    |           |/-------------\   |               /-----+---+-------------+-+-------+----+--+-----+--------------------\| 
 /-+-+------+----+-+\ |  ||    |           ||    /------<-+---+---------------+-----+---+-------------+-+-------+----+--+-->--+--------------------++\
 | | |      |/---+-++-+--++----+-----------++--\ |        |   |               |     |   |             | |       |    |  |     |                    |||
 | | |      ||   | ||/+--++----+-----------++--+-+--------+--\|               |     |   |  /----------+-+-------+\   |  |     |                    |||
 | | |      ||   | ||||  ||    |           || /+-+--------+--++---------------+-----+---+--+----------+-+\      ||   |  |     |                    |||
 | | |      ||   | ||||  ||    |         /-++-++-+--------+--++---------------+-----+---+--+----------+-++-----\||   |  |     |                    |||
 | | |      ||   | ||||  ||    |         | || || |     /--+--++---------------+-----+---+--+----------+-++-----+++---+--+-----+-----\              |||
 | | |      ||   | ||||  ||    |         | || || |     |  |  ||               |     |   |  |          | ||     |||   |  |   /-+-----+\             |||
 | | |      || /-+-++++--++----+---------+-++-++-+-----+--+--++---------------+----\|   |  |          | ||     |||   |  |   | |     ||             |||
 | | | /----++-+-+-++++--++----+---------+-++-++-+-----+--+--++--------------\|    ||  /+--+----\     | ||/----+++---+--+---+-+-----++\            |||
 | | | |  /-++-+-+-++++--++----+---------+-++-++-+-----+--+--++--------------++----++--++--+----+-----+-+++\   |||   |  |   | |     |||            |||
 | | | |  | || | | ||||  ||    |         | || || |     |  |  ||            /-++----++--++--+----+----\| ||||   |||   |  |   | |     |||            |||
 | | | |  | || | | ||||  ||    |         | || || |     |  |  ||            | ||    ||  ||  |/---+----++-++++---+++---+--+--\| |     |||            |||
 | | | |  | || | | ||||  ||    |         |/++-++-+-----+--+--++------\     | ||    ||  ||  ||   | /--++<++++---+++---+--+--++-+-----+++------\     |||
 | | | |/-+-++-+-+-++++--++----+---------++++-++-+-----+--+--++----\ |     | ||    ||  ||  ||   | |  || ||||   |||   |  |  || | /---+++------+--\  |||
 | | | || |/++-+-+-++++--++----+---------++++-++-+-----+--+--++----+-+-----+-++----++--++--++---+-+--++-++++---+++---+-\|  || | |   |||      |  |  |||
 | | | || |||| | | ||||  ||    |         |||| || |     |  |  ||    | |     | ||    ||  ||  ||   | |  || ||||   |||   \-++--++-/ |   |||      |  |  |||
 | | | || |||| | | ||||  ||    |         |||| || \-----+--+--++----+-+-----+-++----++--++--++---+-+--++-++++---+++-----++--++---+---+++------+--+--++/
 | | | || |||| |/+-++++--++----+\        |||| ||       | /+--++----+-+-----+-++\   ||  ||  ||   | |  || ||||   |||     ||  ||   |   |||      |  |  || 
 | | | || |||| ||| ||||  ||    ||        |||| ||       | ||  ||    | |     | |||   ||  ||  ||   | |  || ||||   |||     ||  ||   |   |||      |  |  || 
 | | | \+-++++-+++-++++--++----++--------++++-++-------+-++--++----+-+-----+-/||   ||  ||  || /-+-+--++-++++---+++-----++--++---+\  |||      |  |  || 
 | | |  | |||| ||| ||||  ||    ||   /----++++-++-------+-++--++--\ | |     |  ||   ||  ||  || | | |  || ||||   |||     ||  ||   ||  |||      |  |  || 
 | | \--+-++++-+++-++++--++----++---+----++++-++-------+-++--++--+-+-+-----+--++---++--++--++-+-+-+--+/ ||||   |||     ||  ||   ||  |||      |  |  || 
 | |    |/++++-+++-++++--++----++\  |/---++++-++-------+-++--++--+-+-+-----+--++\  ||  |\--++-+-+-+--+--/|||   |||     ||  ||   \+--+++------+--/  || 
 | |    |||||| ||| ||||  ||    |||  ||   |||| ||       | ||  ||  | | |     \--+++--++--+---++-+-+-+--/   |\+---+++-----++--++----+--++/      |     || 
 | |    ||||\+-+++-++++--++----+++--++---++++-++-------+-++--++--+-+-+--------+++--+/  |/--++-+-+-+------+-+---+++-----++--++\   |  ||       |     || 
 | |    |||| | ||| ||||  ||    |||  ||   |||| ||       | ||  ||  | | |        |||  |   ||  || | | \------+-+---+++-----++--+++---+--++-------/     || 
 | |    |||| | ||| ||||  ||    |||  ||   |||| ||   /---+-++--++--+-+-+---\    |||  |   ||  \+-+-+--------+-+---++/     ||  |||  /+--++------------\|| 
 | |    |||| | ||| ||||/-++----+++--++---++++-++---+---+-++--++--+-+-+---+----+++--+---++---+-+-+--------+-+---++---\  ||  |||  ||  ||            ||| 
 | |    |||| | ||| ||||| ||    |||  ||   |||| ||   |   | ||  ||  | | |   |    |||  |   ||   | | |        | |   ||   |  ||  |||  ||  ||            ||| 
 | |    |||| | ||| ||||| ||    |||  ||   |||| ||   |   | ||  ||  | | |   |    |||  |   ||   | | |        | |   ||   |  ||  |||  ||  ||            ||| 
 | |    |||| | ||| ||||| ||/---+++--++---++++-++---+---+-++--++--+-+-+---+----+++--+---++---+-+-+--------+-+-\ ||   |  ||  |||  ||  ||            ||| 
 | |    |||| | ||\-+++++-+++---+++--++---++++-++---+---+-++--++--+-+-+---+----+++--+---++---+-+-+--------+-+-+-+//--+--++--+++--++-\||            ||| 
 | |    |||| | ||  \++++-+++---/||  ||   |||| || /-+---+-++--++--+-+-+---+----+++--+---++---+-+-+--------+-+-+-+-+\ |  ||  |||  || |||            ||| 
 | |    |\++-+-++---++++-+++----+/  ||  /++++-++-+-+---+-++--++--+-+-+---+----+++--+---++---+-+-+--------+-+-+\| || |  ||  |||  || |||            ||| 
 | |    | || | ||   |||| |||    |   ||  ||||| || | |   | ||  ||  | | |   |    |||  |   ||   | | |/-------+-+-+++-++-+--++--+++--++-+++---\        ||| 
 | |    \-++-+-++---++++-+++----+---++--+++++-++-+-+---+-++--++--+-/ |   |    ||| /+---++---+-+-++-------+-+-+++-++-+\ ||  |||  || |||   |        ||| 
 | |      || | ||   |||| |\+----+---++--+++/| || | |   | \+--++--+---+---+----+/| ||   ||   | | ||       | | ||| || || ||  |||  || |||   |        ||| 
 | |      || | || /-++++-+-+----+---++--+++-+-++-+-+---+--+--++--+---+---+----+\| ||   |\---+-+-++-------+-+-+++-++-++-++--++/  || |||   |        ||| 
 | |      || | ||/+-++++-+-+----+---++--+++-+-++-+-+---+--+--++--+---+---+---\||| ||   |    | | ||       | | ||| || || ||  ||   || |||   |        ||| 
 | |      || | |||| |\++-+-+----+---++--+++-+-++-+-+---+--+--/|  |   | /-+---++++-++---+----+-+-++-------+-+-+++-++-++-++--++---++-+++---+--\     ||| 
 | |/-----++-+-++++-+-++-+-+----+---++--+++-+-++-+-+---+--+---+--+\/-+-+-+---++++-++---+----+-+-++--\    | | ||| || || ||  ||   || |||   |  |     ||| 
 | ||     || | |||| | || | |    |   ||  ||| | || | |   |  |   |  ||| | | |   |||| ||   |    |/+-++--+----+-+-+++-++-++-++--++---++-+++---+--+-\   ||| 
 | ||     || v |||| | \+-+-+----+---++--+++-+-++-+-+---+--+---/  ||| | | |   |||| ||   | /--+++-++--+----+-+-+++-++-++-++--++---++-+++---+-\| |   ||| 
 | ||     || | |||| |  | | |    |   ||  ||| | || | |   |  |      |||/+-+-+---++++-++---+-+--+++-++--+----+-+-+++-++-++-++-\||   || |||   | || |   ||| 
 | ||     || | |||| |  | | |    |   ||  ||| | || | |   | /+------+++++-+-+---++++-++---+-+--+++-++--+-->-+-+-+++-++-++-++-+++---++-+++---+-++-+---+++\
 | ||     || | |||| |  | | |    |   ||  ||| | || | |   | ||     /+++++-+-+---++++-++---+-+--+++-++--+----+-+-+++-++-++-++-+++--\|| |||   | || |   ||||
 | ||     || | |||| |  | | | /--+---++--+++-+-++-+-+---+-++-----++++++-+\|   |||| ||   | |  ||| ||  |    | | ||| || || || |||  ||| |||   | || |   ||||
 | ||/----++-+-++++\|  |/+-+-+--+---++--+++-+-++-+-+---+-++-----++++++-+++---++++\||   | |  ||| ||  |    | | ||| || || || |||  ||| |||   | || |   ||||
 | |||    ||/+-++++++--+++-+-+--+---++--+++-+-++-+-+---+-++-----++++++-+++---+++++++---+-+--+++-++--+-\  | | ||| || || || |||  ||| |||   | || |   ||||
 | |||   /++++-++++++--+++-+-+--+---++--+++-+-++-+-+---+-++-----++++++-+++---+++++++---+-+--+++-++--+\|  | | ||| || || || |||  ||| |||   | || |   ||||
 | |||   ||||| ||||||  ||| | |  |   ||  ||| \-++-+-+---+-+/     |||||| |||   |||||||   \-+--+++-/|  |||  | | ||| || || || |||  ||| |||   | || |   ||||
 | |||  /+++++-++++++--+++-+\|  |   ||  |||   || | |   | |      |||||| |||   |||||||     |  |||  |  |||  | | ||| || || || |||  ||| |||   | || |   ||||
 | |||  |||||| ||||||  ||| |||  |   ||  |||   || | |   | |  /---++++++-+++---+++++++-----+--+++--+--+++--+-+-+++-++-++-++-+++--+++-+++---+-++-+-\ ||||
 | |||  |||||| |||\++--+++-+++--+---++--+++---++-+-+---+-+--+---++++++-+++---++/||||     |  |||  |  |||  | |/+++-++-++-++-+++--+++-+++---+-++-+\| ||||
 | \++--++++++-+++-++--++/ |||  |   ||  |||/--++-+-+---+-+-\|   |||\++-+++---++-++++-----+--+++--+--/||  | ||||| || || || |||  ||| |||   | || ||| ||||
 |  ||  |||||| ||| ||  ||  |||/-+---++--++++--++-+-+---+-+-++---+++-++-+++---++-++++-----+--+++--+---++\ | ||||| || || || |^|  ||| |||   | || ||| ||||
 |  ||  |||||| ||| ||  ||  |||| |   ||  ||||  || | |   | | ||   ||| || |||   || ||||/----+--+++--+---+++-+-+++++-++-++-++-+++--+++-+++--\| || ||| ||||
 |  ||  |||||| ||| ||  ||  |||| |   ||  ||||  || | |   |/+-++---+++-++-+++---++-+++++----+-\|||  |   ||| | ||||| || || || |||  ||| |||  || || ||| ||||
 |  ||  |||||| ||| ||  ||  |||| |   \+--++++--++-+-+---+++-++---+/| || |||  /++-+++++----+-++++-\|   ||| | ||||| || || || |||  ||| |||  || || ||| ||||
 |  ||  |||||| ||| ||  ||  |||| |    |  ||||  || | |   ||| ||   | | || |||  ||| |||||    | |||| ||   ||| | ||||| \+-++-++-+++--+++-/||  || || ||| ||||
 |  ||  |||||| ||| ||  ||  |||| |    |  ||||  || | |   ||| ||   | | || |||  ||| |||||    | |||| ||   ||| | |||||  | || || |||  |||  ||  || || ||| ||||
 |  ||  |||||| ||| ||  ||  |||| |  /-+--++++--++-+-+---+++-++---+-+-++-+++--+++-+++++----+-++++-++---+++-+-+++++--+-++-++-+++--+++--++\ || || ||| ||||
 |  ||  |||||| ||| ||  |\--++++-+--+-+--++++--++-+-+---+++-++---+-+-++-+++--+++-+/|||    | |||| ||   ||| | |||||  | || || |||  |||  ||| || || ||| ||||
 |  ||  |||||| ||| ||  |   |||| |  | |  ||||  || | |   |||/++---+-+\|| |||  ||| | |||    | |||| ||   ||| | |||||  | || || |||  |||  ||| || || ||| ||||
 |  ||  |||||| ||| ||  |   |||| |  | |  ||||  || | |   ||\+++---+-++++-+++--+++-+-+++----+-++++-++---+++-+-+++++--+-++-++-+++--+++--+++-++-++-+++-+++/
 |  ||  |||||| ||| ||  |   |||| |  | |  ||||  || | |   || |||   | |||| |||  ||| | |||    | |||| ||   ||| | |||||  | || || |||  |||  ||| || || ||| ||| 
 |  ||  |||||| ||| ||  |   |||| |  | |  ||||  || | |   || |||   | ||\+-+++--+++-+-+++----+-++++-++---+++-+-+++++>-+-++-++-/||  |||  |^| || || ||| ||| 
/+--++--++++++-+++-++--+---++++-+--+-+--++++--++\| |   || |||   | || | |||  ||| | |||    | |||| ||   ||| | |||||  | || ||  ||  |||  ||| || || ||| ||| 
||  ||  ||||||/+++-++--+---++++-+--+-+--++++--++++-+-\ || |||   | || | |||  ||| | |||    | |||| ||   ||| | |||||  | || ||  ||  |||  ||| || || ||| ||| 
||  ||  |||||||||| ||  |   |||| |  | |  ||||  |||| | | || |||   | || | |||  ||| | |||    | |||| |\---+++-+-+++++--+-++-++--++--+++--+++-+/ || ||| ||| 
||  || /++++++++++-++--+---++++-+--+-+--++++\ |||| | | || |||   | || | |||  ||| | |||    | |||| |    ||| | |||||  | || ||  ||  |||  |||/+--++-+++\||| 
||  || ||||||||||| ||  |   |||| |  | |  ||||| |||| | | || |||   | ||/+-+++--+++-+-+++----+-++++-+----+++-+-+++++--+\|| ||  ||  |||  |||||  || ||||||| 
|| /++-+++++++++++-++--+---++++-+--+\|  ||||| |||| | | || |||   | |||| |||  ||| | |||    | |||| |    ||| | |||||  |||| ||  || /+++--+++++\ || ||||||| 
|| ||| ||||||||||| ||  |   |||| |  |||  ||||| |||| | | || |||   | |||| \++--+++-+-+++----+-++++-+----+++-+-+++++--++++-++--++-++++--++++++-+/ ||||||| 
|| ||| ||||||||||| ||  |   |||| |  |||  ||||| |||| | | || |||   | ||||  ||/-+++-+-+++----+-++++-+----+++-+-+++++--++++-++--++-++++-\|||||| |  ||||||| 
|| ||| ||||||||||| ||  |   ||\+-+--+++--+++++-++++-+-+-++-+++---+-++++--/|| ||| | |||    | |||| |    ||| | |||||  |||| ||  || |||| ||||||| |  ||||||| 
|| ||| ||||||||\++-++--+---++-+-+--+++--+++++-++++-+-+-++-+++---+-++++---++-+++-+-+/|    | |||| |    ||| | |||||  |||| ||  || |||| ||||||| |  ||||||| 
|| ||| |||||||| || ||  |   || | |  |||  ||||| |||| | | || |||   | ||||   || ||| | | |    | |||| |    ||| | |||||  |||| ||  || |||| ||||||| |  ||||||| 
|| ||| |||||||| || ||  |   || | |  |||  ||||| |||| | | || |||/--+-++++---++-+++-+-+-+----+-++++-+----+++-+-+++++-\|||| ||  || |||| ||||||| |  ||||||| 
|| ||| |||||||| || ||  |  /++-+-+--+++--+++++-++++-+-+-++-++++--+-++++---++-+++-+-+-+----+-++++-+----+++-+-+++++-+++++-++\ || |||| ||||||| |  ||||||| 
|| ||| |||||||\-++-++--+--+++-+-+--+++--+++++-++++-+-/ || ||||  | ||||   || ||| | | |    | |||| |    ||| | ||||| ||||| ||| || |||| ||||||| |  ||||||| 
|| \++-+++++++--++-++--+--+++-+-+--+/|  ||||| \+++-+---++-++++--+-++++---++-+++-+-+-+----+-++++-+----+++-/ ||||| ||||| ||| || |||| ||||||| |  ||||||| 
||  || |||\+++--++-++--+--+++-+-+--+-+--+++++--+++-+---++-++++--+-++++---++-+++-+-+-+----+-++++-+----+++---/|||| ||||| ||| || ||\+-+++++++-+--++++/|| 
||  || ||| \++--++-++--+--+++-+-+--+-+--+++++--+++-+---++-++++--+-++++---++-+++-+-+-+----+-++++-+----+++----++++-+++++-/|| || || | ||||||| |  |||| || 
||  || |||  ||  || ||/-+--+++-+-+--+-+--+++++--+++-+---++-++++--+-++++---++-+++-+-+-+----+-++++-+----+++----++++\|||||  || || || | ||||||| |  |||| || 
\+--++-+++--++--++-+++-+--+++-+-+--+-+--+++++--+/| |   || ||||  | ||||   || ||| | | |    | |||| |    |||    ||||||||||  || || || | ||||||| |  |||| || 
 |  || |||  ||  || ||| |  ||| | |  | |  |||||  | | |  /++-++++--+-++++---++-+++-+-+-+----+-++++-+--\ |||    ||||||||||  || || || | ||||||| |  |||| || 
 |  || |||  ||  || ||| |  ||| | |  | |  |||||  | | |  ||| ||\+--+-++++---++-+++-+-+-+----+-++++-+--+-+++----++++++++++--++-++-++-+-+++++++-+--++/| || 
 |  || |||  ||  || ||| |  |||/+-+--+-+--+++++--+-+-+--+++-++-+--+-++++---++-+++-+-+-+----+-++++-+--+-+++----++++++++++-\|| || || | ||||||| |  || | || 
 |  || |||  |\--++-+++-+--+++++-+--+-+--+++++--/ | |  ||| || |  | ||||   |\-+++-+-+-+----+-++++-+--+-+++----++++++++++-+++-++-++-+-/|||||| |  || | || 
 |  || |||  |   || ||| |  \++++-+--+-+--+++++----+-+--+++-++-+--+-++++---+--+++-+-+-+----+-++++-+--+-+++----++++++++++-++/ || || |  |||||| |  || | || 
 |  || |||  |   || ||| |   |||| |  | |  |||||    | |  ||| || |  | ||||   |  ||\-+-+-+----+-++++-+--+-+++----++++++++++-++--++-++-+--++++++-+--++-+-/| 
 |  || |||  |   || ||| |   |||\-+--+-+--+++++----+-+--+++-++-+--+-++++---+--++--+-+-+----+-++++-+--+-++/    |||||||||| ||  || || |  |||||| |  || |  | 
 |  || |||  |   || ||| |   |||  |  | |  |||||    | |  ||| || |  | ||||   |  ||  | | |    | |||| |  | ||     |||||||||| ||  || || |  |||||| |  || |  | 
 |  || |||  |   || ||| |   |||  |  |/+--+++++----+-+--+++-++-+--+-++++\  |  ||  | | |    | |||| |  | ||     |||||||||| ||  || || |  |||||| |  || |  | 
 |  || |||  |   || ||| |   |||  |  |||  |\+++----+-+--+++-++-+--+-+++++--+--++--+-+-+----+-++++-+--+-++-----+++/|||||| ||  || || |  |||||| |  || |  | 
 |  || |||  |   || ||| |   |||  |  ||\--+-+++----+-+--+++-++-+--+-+++++--+--++--/ | |    | |||| |  | ||     \++-++++++-++--++-++-+--++++++-+--+/ |  | 
 |  || |||  |   || ||| |   |||  |  ||   | |||    | |  ||| || |  | |||||  |  ||    | |    | |||| |  | ||      || |||||| ||  || || |  |||\++-+--+--/  | 
 |  || |||  |   || ||| |   ||\--+--++---+-+++----+-+--+++-++-+--+-+++++--+--++----+-+----+-++++-+--+-++------++-++++++-/|  || || |  ||| || |  |     | 
 |  || |||  |   || ||| |   ||   |  ||   | ||| /--+-+--+++-++-+--+-+++++--+--++----+-+----+-++++-+--+-++------++-++++++--+--++-++\|  ||| || |  |     | 
 |  || |||  |   || ||| |   ||   |  ||   v ||| |  | |  |||/++-+--+-+++++--+--++---\| |    | |||| |  | ||      || ||||||  \--++-++++--+++-++-+--+-----/ 
 |  || ||\--+---++-+++-+---++---+--++---+-+++-+--+-+--++++++-+--+-+++++--+--++>--++-+----+-++++-+--+-/|      || ||||||     || \+++--+++-+/ |  |       
 |  || ||   |   || ||| |   \+---+--++---+-+++-+--+-+--++++++-+--+-+++++--+--++---++-+----+-++++-+--+--+-->---/| ||||||     ||  |||  ||| |  |  |       
 | /++-++---+---++-+++-+----+---+--++-\ \-+++-+--+-+--++++++-+--+-+++++--+--++---++-+----+-++++-+--+--+-------/ ||||||     ||  |||  ||| |  |  |       
 \-+++-++---+---++-+/| |    |   |  || |   \++-+--+-+--++++++-+--+-+++/|  |  ||   || \----+-++++-+--+--+---------++++++-----++--+++--+++-/  |  |       
   ||| ||   |   || | | |    |   |  || |    || |  | |  |||||| |  | ||| |  |  ||   ||   /--+-++++-+--+--+-------\ ||||||     ||  |||  |||    |  |       
   ||| ||   |   || | | |    |   |  || |    || |  \-+--++++++-+--+-+++-+--+--++---++---+--+-++++-+--+--+-------+-++/|||     ||  |||  |||    |  |       
   ||| ||   |   || | | |    |   |  || | /--++-+----+--++++++-+--+-+++-+--+--++--\||   |  | |||\-+--+--+-------+-++-+++-----++--++/  |||    |  |       
   ||| ||   |   || | | |    |   |  || | |  || |    \--++++++-+--+-+++-+--/  ||  |||   |  | |||  |  |  |       | || |||     |\--++---+/|    |  |       
 /-+++-++-\ |   || | | |    |   |  || | |  || |       |\++++-+--+-+++-+-----++--+++---+--+-+++--+--+--+-------+-++-+++-----+---++---/ |    |  |       
 | ||| || | |   || | | |    |   |  || | |  \+-+-------+-+++/ |  | ||| |     ||  |||   |  | |||  |  |  |       | || |||     |   ||     |    |  |       
 | ||| || | |   || | | | /--+---+--++-+-+--\| |       |/+++--+--+-+++-+-----++--+++---+--+-+++--+--+--+-------+-++-+++-----+---++-----+---\|  |       
 | ||| || | |   ^| | | | |  |   |  || | |  || |       |||||  |  | ||| |     ||  |||   |  | |\+--+--+--+-------+-++-+++-----/   ||     |   ||  |       
 | ||| || | |   || | \-+-+--+---+--++-+-+--++-+-------+++++--+--+-+++-+-----++--+++---+--+-+-+--+--+--+-------+-/| |||         ||     |   ||  |       
 | ||^ || | |   || |   | |  |   |  || | |  || |       |||||  |  | ||| |     ||  |||   |  \-+-+--+--+--+-------+--+-+++---------++-----+---+/  |       
 | ||| || | |   \+-+---+-+--+---/  || | |  || |       ||||\--+--+-+/| |     \+--+++---+----+-+--/  |  |       |  | |||         ||     |/--+---+-----\ 
 | ||| || | |    | |   | |  |      || | |  || |       ||||   |  | | | |      |  |||   |    | |     |  |       |  | |||         ||     ||  |   |     | 
 | ||| \+-+-+----+-+---+-+--+------++-+-+--+/ |       ||||   \--+-+-+-+------+--+++---+----+-+-----+--+-------+--/ |||         ||     ||  |   |     | 
 | |||  | | |    | |   | |  |      || | |  |  |     /-++++------+-+-+-+------+--+++---+----+-+-----+--+-------+----+++------\  ||     ||  |   |     | 
 | |||  | | |    | |   | |  |      || | |/-+--+-----+-++++------+-+-+-+-\    |  |||   |    | |     |  |       |    |||      |  ||     ||  |   |     | 
 | |||  | | |    \-+---+-+--+------++-+-++-+--+-----+-++++------+-+-+-+-+----/  |||   |    | |     |  |       |    |||      |  ||     ||  |   |     | 
 | \++--+-+-+------+---+-+--+------++-/ || |  |     | ||||      | | \-+-+-------+++---+----+-+-----+--+-------+----/||      |  ||     ||  |   |     | 
 |  ||  | | |      |   | |  |      ||   || |  |     | ||||      | |   | |       |||   |    | |     |  |       |     ||      |  ||     ||  |   |     | 
 |  ||  | | \------+---+-+--+------++---++-+--+-----+-++++------+-+---+-+-------+++---+----+-+-----+--/       |     ||      |  ||     ||  |   |     | 
 |  ||  | |        |   | |  |      ||   || |  |     | ||\+------+-+---+-+-------+++---+----/ \-----+----------+-----++------+--++-----++--+---/     | 
 |  ||  | |        |   \-+--+------++---++-+--+-----+-++-+------+-+---+-+--->---+++---+------------+----------+-----/|      |  ||     ||  |         | 
 |  ||  | |        |     |  |      ||   || |  |     | |\-+------+-+---+-+-------+++---+------------+----------+------+------+--++-----++--/         | 
 |  ||  | |        |     |  |      ||   || |  |     | |  \------+-+---+-+-------+/|/--+------------+----------+------+----\ |  ||     ||            | 
 |  |\--+-+--------/     |  |      ||   || |  |     | |         | |   | |       | ||  |            |          |      |    | |  ||     ||            | 
 |  |   | |              |  | /----++---++-+--+-----+-+---------+-+---+-+->-----+-++--+------------+----------+------+----+-+--++--\  ||            | 
 |  \---+-+--------------+--+-+----++---++-+--+-----+-+---------+-/   | |       | ||  |            |          |      |    | |  ||  |  ||            | 
 |      | |              |  | |    ||   || |  |     | \---------+-----+-+-------+-++--+------------/          |      |    | |  ||  |  ||            | 
 |      | |              |  | |    ||   \+-+--+-----+-----------+-----+-+-------/ \+--+-------->--------------+------/    | |  ||  |  ||            | 
 \------+-/              |  | |    ||    | |  |     ^           \-----+-+----------+--+-----------------------+-----------+-+--/|  |  ||            | 
        |                |  | |    ||    | |  |     |                 | |          |  \-----------------------/           | |   |  |  ||            | 
        |                |  | |    |\----+-+--+-----+-----------------/ |          |                                      | |   |  |  ||            | 
        \----------------+--/ |    |     | |  |     |                   |          |                                      | |   |  |  ||            | 
                         \----+----+-----+-/  |     \-------------------+----------+--------------------------------------+-/   |  |  |\------------/ 
                              |    |     \----+-------------------------/          \--------------------------------------/     |  |  |               
                              |    |          \---------------------------------------------------------------------------------/  |  |               
                              \----+-----------------------------------------------------------------------------------------------/  |               
                                   \--------------------------------------------------------------------------------------------------/               
                                                                                                                                                      